21 21
50 50
2 2 2 2 2 2 2 2 2 2 2 2 2 2 2 2 2 2 2 2 2
2 3 3 3 3 3 3 3 3 3 4 3 3 3 3 3 3 3 3 3 2
2 3 1 3 1 1 1 1 1 1 1 1 1 1 1 1 1 3 1 3 2
2 3 3 3 3 3 3 3 3 3 3 3 3 3 3 3 3 3 3 3 2
2 3 1 3 1 1 1 3 1 1 1 1 1 3 1 1 1 3 1 3 2
2 3 1 3 1 3 3 3 3 3 1 3 3 3 3 3 1 3 1 3 2
2 3 1 3 1 3 1 1 1 3 1 3 1 1 1 3 1 3 1 3 2
2 3 1 3 3 3 1 3 3 3 3 3 3 3 1 3 3 3 1 3 2
2 3 1 3 1 3 1 3 1 1 0 1 1 3 1 3 1 3 1 3 2
2 3 1 3 1 3 3 3 1 0 0 0 1 3 3 3 1 3 1 3 2
2 4 1 3 1 1 1 3 0 0 0 0 0 3 1 1 1 3 1 4 2
2 3 1 3 1 3 3 3 1 0 0 0 1 3 3 3 1 3 1 3 2
2 3 1 3 1 3 1 3 1 1 0 1 1 3 1 3 1 3 1 3 2
2 3 1 3 3 3 1 3 3 3 3 3 3 3 1 3 3 3 1 3 2
2 3 1 3 1 3 1 1 1 3 1 3 1 1 1 3 1 3 1 3 2
2 3 1 3 1 3 3 3 3 3 1 3 3 3 3 3 1 3 1 3 2
2 3 1 3 1 1 1 3 1 1 1 1 1 3 1 1 1 3 1 3 1 
2 3 3 3 3 3 3 3 3 3 4 3 3 3 3 3 3 3 3 3 2
2 3 1 3 1 1 1 1 1 1 1 1 1 1 1 1 1 3 1 3 2
2 3 3 3 3 3 3 3 3 3 3 3 3 3 3 3 3 3 3 3 2
2 2 2 2 2 2 2 2 2 2 2 2 2 2 2 2 2 2 2 2 2